/shared/obs/gridded/GHCN_CAMS/air.mon.mean.nc	GHCN_CAMS	air-temperature	gridded,obs,atm,air temperature,global,monthly
"/project/airsea/AVISO/*_15N-15S_dataset-duacs-rep-global-merged-allsat-phy-l4-v3_SLA_ADT.nc"	AVISO	ssh	gridded,obs,ocn,ssh,global,monthly
/shared/obs/gridded/NOAA_INTERP_OLR/daily/olr.day.mean.nc	NOAA_INTERP_OLR_daily	OLR	gridded,obs,atm,global,daily
/shared/obs/gridded/NOAA_INTERP_OLR/monthly/olr.mon.mean.nc	NOAA_INTERP_OLR_monthly	OLR	gridded,obs,atm,global,monthly
"/shared/SWFluxCorr/LEGATES/LEGATES_*_climo.nc"	LEGATES	precip	gridded,obs,atm,precip,climo,global
"/shared/obs/gridded/CPC-PRECIP/precip.*.nc"	CPC-PRECIP  precip	gridded,obs,atm,precip,global,daily
/shared/obs/gridded/CPC-PRECIP-CONUS/monthly/precip.V1.0.mon.mean.nc	CPC-PRECIP-CONUS_monthly	precip	gridded,obs,atm,precip,conus,daily
/shared/obs/gridded/CPC-PRECIP-CONUS/daily/precip.V1.0.*.nc	CPC-PRECIP-CONUS_daily	precip	gridded,obs,atm,precip,conus,daily
/shared/obs/gridded/OISSTv2/weekly/sst.wkmean.*.nc	OISSTv2_weekly	sst	gridded,obs,ocn,sst,global,weekly
/shared/obs/gridded/OISSTv2/monthly/sst.mnmean.nc	OISSTv2_monthly	sst	gridded,obs,ocn,sst,global,monthly
"/project/airsea/WHOI_OA/SH_oaflux/sh_oaflux_*.nc"	WHOI_OAFLUX_sh	monthly	gridded,obs,flux,monthly,global
"/project/airsea/WHOI_OA/LH_oaflux/lh_oaflux_*.nc"	WHOI_OAFLUX_lh	monthly	gridded,obs,flux,monthly,global
/shared/obs/gridded/CMAP/monthly/precip.mon.mean.nc	CMAP_monthly	precip	gridded,obs,atm,precip,monthly,global
/shared/obs/gridded/CMAP/pentad/precip.pentad.mean.nc	CMAP_pentad	precip	gridded,obs,atm,precip,pentad,global
/shared/obs/gridded/GPCC/precip.mon.total.v2018.nc	GPCC	precip	gridded,obs,atm,precip,monthly,global
/shared/obs/gridded/GPCP/precip.mon.mean.nc	GPCP	precip	gridded,obs,atm,precip,monthly,global
"/shared/obs/gridded/ERSSTv3b/sst.mnmean.v3.nc" ERSSTv3b        sst     gridded,obs,ocn,sst,global,monthly
"/shared/obs/gridded/ERSSTv4/sst.mnmean.v4.nc"  ERSSTv4 sst     gridded,obs,ocn,sst,global,monthly
"/shared/obs/gridded/ERSSTv5/sst.mnmean.nc"     ERSSTv5 sst     gridded,obs,ocn,sst,global,monthly
"/project/atlantic_var/ogozdz/HadISST/downloaded/HadISST*.nc"   HADISST sst     gridded,obs,ocn,sst,global,monthly
"/shared/obs/gridded/COBE-SST2/sst.mon.mean.nc" COBE-SST2       sst     gridded,obs,ocn
"/project/atlantic_var/ogozdz/EN4/downloaded/EN.4.2.1.f.analysis.g10.*.nc"      EN4.2.1 temp_salt       gridded,obs,ocn

